# Layer 0
11100000000001111111111111111111111111111111000000
11100000000001111111111111111111111111111111000000
11100000000001111111111111111111111111111111000000
11100000000001111111111111111111111111000000000000
11100000000001111111111111111111111111000000000000
11111111111111111111111111111111100000000000000000
11111111111111111111111111111111100000000000000000
11111111111111111111111111100000000000000000000000
11100000000001111111111111000000000000000000000000
11100000000001111111110000000000000000000000000000
11100000000001111111110000000000000000000000000000
11100000000001111100000000000000000000000000000000
11100000000001111100000000000000000000000000000000
11100000000001111100000000000000000000000000000000
 
# Layer 1
22200000000002222222222222224222222222222200000000
22200000000002222222222222224222222222222200000000
22200000000002222222222222224222222222000000000000
22200000000002222222222222224222222222000000000000
22200000000002222222222222222222200000000000000000
22222222222222222222222222222222200000000000000000
22222222222222222222222222200000000000000000000000
22222222222222225222222222200000000000000001000000
22200000000002222222200000000000000000000000000000
22200000000002222222200000000000000000000000000000
22200000000002222000000000000000000000000000000000
22200000000002222000000000000000000000000000000000

# Layer 2
03000000000000002222222222200000000000000000000000
03000000000000002222222222200000000000000000000000
03000000000000002222222222200000000000000000000000
03000000000000002222222222200000000000000000000000
03000000000000002222222222200000000000000000000000
03000000000000000000000000000000000000000000000000
03000000000000007000000000000000000000000000000000
03000000000000000000000000000000000000000000000000
03060000000000000000000000000000000000000000000000
03000000000000000000000000000000000000000000000000
00000000000000000000000000000000000000000000000000

# Layer 3
00000000000000000222222220000000000000000000000000
00000000000000000222222220000000000000000000000000
00000000000000000222222220000000000000000000000000
00000000000000000222222220000000000000000000000000
00000000000000000000000000000000000000000000000000
00000000000000000000000000000000000000000000000000
00000000000000000000000000000000000000000000000000
00000000000000000000000000000000000000000000000000
00060000000000000000000000000000000000000000000000
00000000000000000000000000000000000000000000000000
00000000000000000000000000000000000000000000000000

# Layer 4
00000000000000003000000000000000000000000000000000
00000000000000003000000000700000000000000000000000
00000000000000003000000000000000000000000000000000
00000000000000003000000000000000000000000000000000
00000000000000000000000000000000000000000000000000
00000000000000000000000000000000000000000000000000
00000000000000000000000000000000000000000000000000
00000000000000000000000000000000000000000000000000
00060000000000000000000000000000000000000000000000
00000000000000000000000000000000000000000000000000