# Layer 0
0000000002
0111111100
0110001100
0110001100
0000000002

# Layer 1
0000000002
0000000000
0020000200
0000000000
0000000000

# Layer 2
0000000003
0000000000
0030000300
0000000000
0000000000
